Student_ID,Math_Score,English_Score,Science_Score,History_Score,Total_Marks
1,78,85,90,75,328
2,85,80,92,88,345
3,92,88,78,90,348
4,65,75,85,80,305
5,78,92,88,85,343
6,88,85,90,92,355
7,75,80,78,70,303
8,90,92,85,88,355
9,82,78,75,80,315
10,95,90,88,92,365